111111111
10C01C0C1
1CPC11E01
10C0000H1
111111111
