1111111111111
1E000000000C1
1110000C00001
1P000000C00N1
1111111111111
